11$.33./...
2.#..3222..
...........
111........
$.1........
..3.....@..
..2........
...*.......
...........
.......3333
........$.3