...........
..@....*...
...........
.$.........
........#..
./..$......
...........
...........
...#.......
.....$.....
...........