.11233...$.
..@..3.*..2
.....1....2
..........1
2.......#..
2/.........
13.........
.32........
.$.#.......
...........
...........