...........
...$...*...
..*........
...........
...$..../..
...........
..@........
.......#...
$..........
...........
........$..