33.........
.2.$...*...
.11223.....
.....1.....
.....223...
.......31..
..@........
..2........
..3.....#..
223.*..12..
1......$1/.