...........
..$........
.....*.....
...........
.#...@..#..
...........
....#......
$..........
...........
.......$...
./.........