213112.....
1.$.22.....
....*......
...........
..#..@..#..
1123.22....
../311.....
...1.......
...2..*...2
.332...$133
.....2311..