...........
.@...*..$..
...........
.....*.....
...........
..#........
.......$...
.$.........
.........#.
.....*.....
../........