2213.331.1.
1@...*..$22
........11.
.....*.....
.......2...
.......3...
#......31.1
..3........
..3....3#..
$21.*..12..
11/.....2.$